-- variables elements

set # to wall;
set _ to floor;
set + to deadend;
set * to end;

-- creation du terrain
create terrain
#____#####_#___#__________
####_#_#####_#_####_####__
_____#___#_#_#____#____#__
_###_###_#_#_##_#_#_######
_______#_#_#____#_#_______
_#####_#_#_######_#_##____
_#_______#________#_#___##
_#_###_#######+####___#___
_#_#____*__#*#_#_________#
_#_#_#####_#_#_#_###___###
_#_#_____#_#_#_#_____#__#_
___#####_#_#_#_####_##_###
##_#_____#___#_______#####
___#############+###______
##___#____#_#______#######
###__#_#_###_#########____
___#######_#_#_#_#####____
__#_#_#______###_______##_
_#####*#_###__#_#_#_______
___#_#####_#_#_#_###___###
;

-- apparition des montres

spawn skeleton(6,4,(RIGHT*4,DOWN*4,LEFT*4,UP*2));
spawn skeleton(6,4,(RIGHT*4,DOWN*4,LEFT*4,UP*2));
spawn bat(1,4,(RIGHT*3,RESTART));
spawn bat(19,2,(DOWN*3,RESTART));
spawn player(1,1);