-- variable element
set # to wall;
set _ to floor;
set * to end;

-- creation du terrain utilise les variables
create terrain
#_#######################
#_____#_____#####_______#
#_###_#_###_______#####_#
#_###_#_#########_#___#_#
#___#_______#####_#_#_#_#
#################_#_#_#_#
#_________________#_###_#
#_#################_____#
#_________________#######
#_##############________#
#_##________###########_#
#_##_######_##_____####_#
#____#______##_###______#
####_#########_##########
#____#__________________#
#_####_########_#######_#
#_#____#________#_____#_#
#_#_####_######_#_#####_#
#_#############_#_______#
#_______#_______#_#######
#################_#_____#
#_##########____#_#_###_#
#____________##_#___###_#
############_##_#######_#
#_____+++____##_________#
#########################
;

-- apparition des montres


spawn ladder(8,24,7,19);
spawn ladder(7,24,9,19);
spawn ladder(6,24,6,12);

spawn skeleton(4,6,(RIGHT*4,RESTART));
spawn bat(7,14,(RIGHT*4,RESTART));

spawn bookshelf(23,6,1,21);

spawn chest(11,19,0);
spawn chest(8,16,0);
spawn chest(3,4,0);

spawn chest(3,4,1);
spawn chest(23,1,1);
spawn chest(9,22,1);




spawn end(1,24,21,5);

spawn player(1,1);

